>+-++<>-+--><[+-[
]+-]<+--+>[+--+]<
[+>+<-]><----[-->
+++<]>--.--------
-.+++.[++>---<]>+
+.-[----->++<]>-.
+[->+++<]>+.+++++
++++++.----------
--.----[->+++<]>+
.-[-->+++++<]>---
.------.[--->+<]>
++.[-]>+-++<>-+--
><[+-[]+-]<+--+>[
+--+]<[+>+<-]><>+
-++<>-+--><[+-[]+
-]<+--+>[+--+]<[]
