+++++++++++[>++++
+++++++<-]>+[<+>-
]-[>+<-------]>--
-[<+>-][<+>-]>++>
+[>++[-<++++++>]<
<]>[<+>-]>+>++[++
>++[-<+++++>]<<]>
[<+>-]>+>+[>++++[
-<++++>]<<]>[<+>-
]++++++++[>++++++
+++++<-]>+[<+>-]+
++>>+>+[->+++[-<+
++++>]<<]>[<+>-]+
+++++++[>++++++++
<-]>+[<+>-]+++>++
++++>+>+-++<>-+--
